20 20
100 100
3 3 3 3 3 3 3 3 3 3 3 3 3 3 3 3 3 3 3 3
2 0 0 0 0 0 5 0 0 0 0 0 0 0 0 0 0 0 1 2
2 0 0 0 4 4 4 4 4 4 4 4 4 4 0 0 0 0 1 2
2 0 0 0 0 0 0 0 0 0 0 0 0 4 0 0 0 0 1 2
2 0 0 0 1 1 1 1 1 1 1 1 1 1 0 0 0 0 1 2
2 0 0 0 4 1 1 1 1 1 1 0 0 4 0 0 0 0 1 2
2 0 0 0 4 0 1 1 1 1 1 1 0 4 0 0 0 0 1 2
2 0 0 0 4 0 0 1 1 1 1 4 4 4 0 0 0 0 1 2
2 1 0 0 4 0 1 1 1 1 1 4 1 0 0 0 0 0 1 2
2 1 0 0 4 4 4 4 1 1 1 1 1 4 0 0 0 0 1 2
2 1 0 0 4 4 4 4 4 4 0 4 4 4 0 0 0 0 1 2
2 1 0 0 0 0 0 0 0 0 0 0 0 0 0 0 0 0 1 2
2 1 0 0 0 0 0 0 0 0 0 0 0 0 0 0 0 0 1 2
2 1 0 0 0 0 1 1 1 1 1 1 0 0 0 0 0 4 1 2
2 1 0 0 0 0 0 0 1 1 1 0 0 3 3 3 4 0 1 2
2 1 0 0 0 0 0 0 0 1 0 1 1 1 1 0 0 0 1 2
2 1 0 0 0 0 0 0 1 1 1 1 1 1 0 0 0 0 1 2
2 1 0 0 0 0 0 0 1 1 0 1 1 1 1 0 0 0 1 2
2 1 0 0 0 0 0 0 0 0 0 0 0 0 0 0 0 0 1 2
2 3 3 3 3 3 3 3 3 3 3 3 3 3 3 3 3 3 3 2